NO textures/eagle.xpm
SO textures/greystone.xpm
EA textures/mossy.xpm

WE textures/redbrick.xpm
F       0, 0, 1
C 0,2,0



    
1111
1001
10W1
1111